############
#         ##
# ####### ##
#         ##
# ####### ##
#F        ##
# # ### ####
# # #     ##
# # ### ####
#    T     #
########## #
############